11111111111
1C0000C00C1
11100101001
1P0001001E1
11111111111