1111111111111111111111111111
1C0000C00C00111000000000C001
101001010010CE10101001000001
1010010010101110001001000001
1P00000000000000000000000C01
1000000000000000000000000001
101001010010C000101001000001
1010010010101010001001000001
11C0000000000000000000100001
1111111111111111111111111111