1111111111111111111111111111111111
1000000000000000000000000000000001
101001010010CE00101001000000010101
1010010010101010001001000000010101
1P00000000000000000000000000000001
1000000000000000000000000000000001
101001010010C000101001000000010101
1010010010101010001001000000010101
1000000000000000000000000000000001
1111111111111111111111111111111111